ffffffffff060ff0fffff0f
aaaaaaaaaaa1aaaaaaaaaaa
f000311311121113114000f
f000100100000001001000f
c-1120021113111200211-c
f000213200010002132000f
f000001000010000010000f
bbbbbb907112117009bbbbb
f000000000010000000000f
f000000000080000000000f
cffcffcffcfcfcffcffcffc
