fffffffff6fffffffffffff
f000000001000aba000000f
f0ac311112111131400000f
f0ba100001caa0101b0000f
f71120-001090010211900f
fcbb101001010010100000f
f0cc212112121121200cc0f
f00010000100a010100cccf
f811200001000010211-00f
f000211112111121200000f
fffffffffffffffffffffff
